datetime,rm,ru,rf,rs,rb,sz,ss,cm
2023-05-05 08:40:01,4046680,464300,3736016,201800,56,4063228,3271716,1108712
2023-05-05 08:45:02,4046680,461548,3733404,201800,56,4063228,3271856,1109004
2023-05-05 08:50:01,4046680,460680,3732536,201800,56,4063228,3271856,1109332
2023-05-05 08:55:01,4046680,538736,3810656,209992,56,4063228,3271920,1118020
2023-05-05 09:00:01,4046680,769340,4041368,209992,56,4063228,3272028,1118700
2023-05-05 09:05:02,4046680,822056,4094084,210024,56,4063228,3272028,1119656
2023-05-05 09:10:01,4046680,818376,4090408,210024,56,4063228,3272032,1119936
2023-05-05 09:15:01,4046680,823432,4095464,218184,56,4063228,3272032,1129940
2023-05-05 09:20:01,4046680,840180,4116000,205560,56,4063228,3275820,1117812
2023-05-05 09:25:01,4046680,841932,4117784,205560,56,4063228,3275852,1118160
2023-05-05 09:30:02,4046680,840368,4116264,205560,56,4063228,3275896,1118580
2023-05-05 09:35:01,4046680,622332,3898236,213752,56,4063228,3275904,1334384
2023-05-05 09:40:01,4046680,586808,3885204,213896,56,4063228,3298396,1800288
2023-05-05 09:45:01,4046680,298608,3597564,213840,56,4063228,3298956,2011388
2023-05-05 09:50:01,4046680,225156,3636732,220584,56,4063228,3411576,1988380
2023-05-05 09:55:01,4046680,220348,3633736,205616,56,4063228,3413388,1888664
2023-05-05 10:00:02,4046680,219176,3632612,205616,56,4063228,3413436,1889044
2023-05-05 10:05:02,4046680,192288,3605724,213864,56,4063228,3413436,1898176
2023-05-05 10:10:01,4046680,416384,3826304,211244,56,4063228,3409920,1693180
2023-05-05 10:15:01,4046680,528136,3938076,211244,56,4063228,3409940,1697628
2023-05-05 10:20:02,4046680,698088,4108852,211244,56,4063228,3410764,1699596
2023-05-05 10:25:01,4046680,697952,4111056,205268,56,4063228,3413104,1694100
2023-05-05 10:30:01,4046680,692500,4105612,205268,56,4063228,3413112,1694492
2023-05-05 10:35:01,4046680,691492,4104604,205268,56,4063228,3413112,1694760
2023-05-05 10:40:01,4046680,688968,4102300,205268,56,4063228,3413332,1696008
2023-05-05 10:45:01,4046680,688180,4101532,205268,56,4063228,3413352,1696296
2023-05-05 10:50:01,4046680,679888,4093240,213460,56,4063228,3413352,1704744
2023-05-05 10:55:01,4046680,669484,4082840,213460,56,4063228,3413356,1705012
2023-05-05 11:00:01,4046680,668484,4081840,213460,56,4063228,3413356,1705248
2023-05-05 11:05:01,4046680,671560,4084916,213516,56,4063228,3413356,1705700
2023-05-05 11:10:01,4046680,664352,4077708,213516,56,4063228,3413356,1705952
2023-05-05 11:15:01,4046680,672288,4085992,205672,56,4063228,3413704,1699356
2023-05-05 11:20:01,4046680,641288,4055000,205616,56,4063228,3413712,1703352
2023-05-05 11:25:01,4046680,638188,4051912,205616,56,4063228,3413724,1703600
2023-05-05 11:30:01,4046680,655428,4069152,205616,56,4063228,3413724,1703848
2023-05-05 11:35:01,4046680,645572,4059296,205616,56,4063228,3413724,1704136
2023-05-05 11:40:02,4046680,674340,4088088,213808,56,4063228,3413748,1713028
2023-05-05 11:45:02,4046680,674848,4088596,213808,56,4063228,3413748,1713148
2023-05-05 11:50:02,4046680,680664,4094420,213808,56,4063228,3413756,1713488
2023-05-05 11:55:02,4046680,679432,4093216,213808,56,4063228,3413784,1713760
2023-05-05 12:00:02,4046680,696044,4109828,213808,56,4063228,3413784,1714012
2023-05-05 12:05:02,4046680,681540,4095332,222000,56,4063228,3413792,1722556
2023-05-05 12:10:02,4046680,696508,4110368,205616,56,4063228,3413860,1706536
2023-05-05 12:15:02,4046680,691944,4105824,205616,56,4063228,3413880,1708356
2023-05-05 12:20:02,4046680,688552,4102556,205616,56,4063228,3414004,1708972
2023-05-05 12:25:02,4046680,700664,4114736,205616,56,4063228,3414072,1709428
2023-05-05 12:30:02,4046680,699896,4113980,205564,56,4063228,3414084,1709588
2023-05-05 12:35:02,4046680,685328,4099416,213808,56,4063228,3414088,1717996
2023-05-05 12:40:02,4046680,684532,4098620,213808,56,4063228,3414088,1718172
2023-05-05 12:45:01,4046680,668076,4082164,213808,56,4063228,3414088,1718332
2023-05-05 12:50:01,4046680,655100,4069192,213808,56,4063228,3414092,1718500
2023-05-05 12:55:01,4046680,655288,4069380,213808,56,4063228,3414092,1718700
2023-05-05 13:00:01,4046680,656468,4070560,213808,56,4063228,3414092,1718864
2023-05-05 13:05:02,4046680,632360,4046452,222056,56,4063228,3414092,1727324
2023-05-05 13:10:02,4046680,632648,4046740,222056,56,4063228,3414092,1727380
2023-05-05 13:15:02,4046680,664044,4078136,205616,56,4063228,3414092,1711596
2023-05-05 13:20:02,4046680,664244,4078336,205616,56,4063228,3414092,1711892
2023-05-05 13:25:02,4046680,654108,4068200,205616,56,4063228,3414092,1712120
2023-05-05 13:30:01,4046680,645096,4059188,205616,56,4063228,3414092,1715672
2023-05-05 13:35:02,4046680,688044,4102136,205616,56,4063228,3414092,1715924
2023-05-05 13:40:02,4046680,680216,4094308,213808,56,4063228,3414092,1724320
2023-05-05 13:45:02,4046680,679392,4093484,213808,56,4063228,3414092,1724512
2023-05-05 13:50:01,4046680,672776,4086868,213808,56,4063228,3414092,1724684
2023-05-05 13:55:01,4046680,672420,4086512,213808,56,4063228,3414092,1724892
2023-05-05 14:00:02,4046680,672996,4087088,213808,56,4063228,3414092,1725080
2023-05-05 14:05:01,4046680,641448,4055540,213864,56,4063228,3414092,1725336
2023-05-05 14:10:01,4046680,647240,4061332,222000,56,4063228,3414092,1736456
2023-05-05 14:15:01,4046680,625316,4039408,205616,56,4063228,3414092,1720344
2023-05-05 14:20:01,4046680,625420,4039512,205636,56,4063228,3414092,1720624
2023-05-05 14:25:01,4046680,622712,4036804,205616,56,4063228,3414092,1720788
2023-05-05 14:30:01,4046680,400712,3814804,205616,56,4063228,3414092,1721616
2023-05-05 14:35:01,4046680,400396,3814488,205616,56,4063228,3414092,1721748
2023-05-05 14:40:01,4046680,392000,3806092,213808,56,4063228,3414092,1730064
2023-05-05 14:45:01,4046680,247748,3661840,213808,56,4063228,3414092,1730292
2023-05-05 14:50:02,4046680,165544,3579636,213808,56,4063228,3414092,1730492
2023-05-05 14:55:02,4046680,224136,3638228,213808,56,4063228,3414092,1726060
2023-05-05 15:00:01,4046680,176544,3590636,213808,56,4063228,3414092,1726248
2023-05-05 15:05:02,4046680,489896,3900152,210760,56,4063228,3410256,1510516
2023-05-05 15:10:02,4046680,490144,3900400,210760,56,4063228,3410256,1510692
2023-05-05 15:15:02,4046680,378016,3791276,205564,56,4063228,3413260,1505668
2023-05-05 15:20:02,4046680,378388,3791648,205564,56,4063228,3413260,1505948
2023-05-05 15:25:02,4046680,377840,3791100,205564,56,4063228,3413260,1506116
2023-05-05 15:30:02,4046680,310468,3723732,205564,56,4063228,3413264,1506396
2023-05-05 15:35:02,4046680,235324,3648592,205564,56,4063228,3413268,1506544
2023-05-05 15:40:02,4046680,242120,3655432,205564,56,4063228,3413312,1506856
2023-05-05 15:45:02,4046680,236008,3649332,213756,56,4063228,3413324,1515284
2023-05-05 15:50:02,4046680,205008,3618332,213756,56,4063228,3413324,1515484
2023-05-05 15:55:02,4046680,191244,3604568,213756,56,4063228,3413324,1515628
2023-05-05 16:00:02,4046680,174876,3588208,213764,56,4063228,3413332,1515760
2023-05-05 16:05:01,4046680,158536,3571876,213828,56,4063228,3413340,1515880
2023-05-05 16:10:01,4046680,147612,3560952,213828,56,4063228,3413340,1516072
2023-05-05 16:15:01,4046680,290056,3697132,208800,56,4063228,3407076,1293928
2023-05-05 16:20:01,4046680,295592,3707436,205376,56,4063228,3411844,1290736
2023-05-05 16:25:01,4046680,294792,3706636,205376,56,4063228,3411844,1290912
2023-05-05 16:30:01,4046680,294428,3706276,205380,56,4063228,3411848,1291104
2023-05-05 16:35:01,4046680,294804,3706652,205380,56,4063228,3411848,1291280
2023-05-05 16:40:01,4046680,294420,3706276,205388,56,4063228,3411856,1291448
2023-05-05 16:45:01,4046680,294156,3706012,205388,56,4063228,3411856,1291628
2023-05-05 16:50:01,4046680,285616,3697472,213580,56,4063228,3411856,1299992
2023-05-05 16:55:01,4046680,340424,3752292,213584,56,4063228,3411868,1300180
2023-05-05 17:00:01,4046680,341152,3753020,213584,56,4063228,3411868,1300352
2023-05-05 17:05:01,4046680,323712,3735580,213640,56,4063228,3411868,1300676
2023-05-05 17:10:01,4046680,392216,3802464,212388,56,4063228,3410248,1248952
2023-05-05 17:15:01,4046680,392108,3802356,212388,56,4063228,3410248,1249120
2023-05-05 17:20:01,4046680,383428,3793684,220588,56,4063228,3410256,1257584
2023-05-05 17:25:01,4046680,399052,3810704,205600,56,4063228,3411652,1242740
2023-05-05 17:30:01,4046680,399284,3810936,205600,56,4063228,3411652,1242848
2023-05-05 17:35:01,4046680,398680,3810344,205612,56,4063228,3411664,1242988
2023-05-05 17:40:01,4046680,398108,3809772,205612,56,4063228,3411664,1243172
2023-05-05 17:45:02,4046680,397812,3809476,205612,56,4063228,3411664,1243376
2023-05-05 17:50:02,4046680,397936,3809600,205612,56,4063228,3411664,1243544
2023-05-05 17:55:01,4046680,388712,3800376,213804,56,4063228,3411664,1253584
2023-05-05 18:00:02,4046680,388944,3800608,213804,56,4063228,3411664,1253760
2023-05-05 18:05:02,4046680,350712,3762376,213860,56,4063228,3411664,1259340
2023-05-05 18:10:02,4046680,352644,3764312,213860,56,4063228,3411668,1259528
2023-05-05 18:15:02,4046680,366120,3777788,213804,56,4063228,3411668,1261936
2023-05-05 18:20:02,4046680,366348,3778016,213804,56,4063228,3411668,1262308
2023-05-05 18:25:02,4046680,357812,3769480,221996,56,4063228,3411668,1270600
2023-05-05 18:30:02,4046680,374088,3785756,205612,56,4063228,3411668,1254384
2023-05-05 18:35:02,4046680,373436,3785104,205612,56,4063228,3411668,1254564
2023-05-05 18:40:02,4046680,373544,3785212,205612,56,4063228,3411668,1254732
2023-05-05 18:45:02,4046680,373064,3784732,205612,56,4063228,3411668,1254892
2023-05-05 18:50:01,4046680,373188,3784856,205612,56,4063228,3411668,1255056
2023-05-05 18:55:01,4046680,373188,3784856,205612,56,4063228,3411668,1255120
2023-05-05 19:00:02,4046680,373312,3784980,205612,56,4063228,3411668,1255276
2023-05-05 19:05:02,4046680,348184,3759852,213860,56,4063228,3411668,1263656
2023-05-05 19:10:02,4046680,362108,3773776,213804,56,4063228,3411668,1266248
2023-05-05 19:15:02,4046680,361892,3773560,213804,56,4063228,3411668,1266460
2023-05-05 19:20:02,4046680,362016,3773684,213804,56,4063228,3411668,1266732
2023-05-05 19:25:02,4046680,361364,3773032,213804,56,4063228,3411668,1266924
2023-05-05 19:30:01,4046680,360952,3772620,213804,56,4063228,3411668,1267096
2023-05-05 19:35:01,4046680,352700,3764368,221996,56,4063228,3411668,1275464
2023-05-05 19:40:01,4046680,365100,3776852,205612,56,4063228,3411752,1259556
2023-05-05 19:45:01,4046680,364464,3776216,205612,56,4063228,3411752,1259736
2023-05-05 19:50:02,4046680,363768,3775520,205612,56,4063228,3411752,1259908
2023-05-05 19:55:02,4046680,363736,3775488,205612,56,4063228,3411752,1260084
2023-05-05 20:00:02,4046680,364604,3776356,205612,56,4063228,3411752,1260268
2023-05-05 20:05:02,4046680,361008,3772760,205612,56,4063228,3411752,1263176
2023-05-05 20:10:02,4046680,352232,3763984,213804,56,4063228,3411752,1271552
2023-05-05 20:15:02,4046680,352232,3763984,213804,56,4063228,3411752,1271724
2023-05-05 20:20:02,4046680,302104,3713856,213804,56,4063228,3411752,1271888
2023-05-05 20:25:02,4046680,302096,3713848,213804,56,4063228,3411752,1272024
2023-05-05 20:30:02,4046680,305168,3716920,213804,56,4063228,3411752,1272228
2023-05-05 20:35:02,4046680,303432,3715184,213804,56,4063228,3411752,1272404
2023-05-05 20:40:02,4046680,302816,3714568,213860,56,4063228,3411752,1272624
2023-05-05 20:45:02,4046680,294348,3706100,221996,56,4063228,3411752,1280908
2023-05-05 20:50:02,4046680,331260,3743012,205612,56,4063228,3411752,1264712
2023-05-05 20:55:02,4046680,331100,3742852,205612,56,4063228,3411752,1264904
2023-05-05 21:00:01,4046680,331728,3743480,205612,56,4063228,3411752,1265068
2023-05-05 21:05:01,4046680,380776,3790540,204048,56,4063228,3409764,1226884
2023-05-05 21:10:01,4046680,412848,3822612,204048,56,4063228,3409764,1226984
2023-05-05 21:15:01,4046680,404820,3814584,212240,56,4063228,3409764,1235344
2023-05-05 21:20:02,4046680,404820,3814584,212240,56,4063228,3409764,1235616
2023-05-05 21:25:01,4046680,404168,3813932,212240,56,4063228,3409764,1235784
2023-05-05 21:30:02,4046680,403772,3813536,212240,56,4063228,3409764,1235960
2023-05-05 21:35:01,4046680,399084,3808848,212240,56,4063228,3409764,1236128
2023-05-05 21:40:02,4046680,399208,3808972,212240,56,4063228,3409764,1236296
2023-05-05 21:45:02,4046680,398884,3808648,212240,56,4063228,3409764,1236384
2023-05-05 21:50:02,4046680,390188,3799952,220432,56,4063228,3409764,1244704
2023-05-05 21:55:02,4046680,405288,3816616,205612,56,4063228,3411328,1230068
2023-05-05 22:00:01,4046680,405900,3817232,205612,56,4063228,3411332,1230236
2023-05-05 22:05:02,4046680,389556,3800888,205668,56,4063228,3411332,1230480
2023-05-05 22:10:01,4046680,389340,3800672,205668,56,4063228,3411332,1230620
2023-05-05 22:15:01,4046680,404944,3816276,205612,56,4063228,3411332,1231300
2023-05-05 22:20:01,4046680,404304,3815636,205612,56,4063228,3411332,1231548
2023-05-05 22:25:01,4046680,347904,3759236,213804,56,4063228,3411332,1239928
2023-05-05 22:30:01,4046680,421768,3833100,213804,56,4063228,3411332,1240168
2023-05-05 22:35:02,4046680,422924,3834256,213804,56,4063228,3411332,1240356
2023-05-05 22:40:02,4046680,421928,3833260,213804,56,4063228,3411332,1240520
2023-05-05 22:45:02,4046680,427704,3839036,213804,56,4063228,3411332,1240716
2023-05-05 22:50:01,4046680,425644,3836980,213808,56,4063228,3411336,1240888
2023-05-05 22:55:02,4046680,417592,3828928,222000,56,4063228,3411336,1249264
2023-05-05 23:00:02,4046680,434188,3845524,205616,56,4063228,3411336,1233052
2023-05-05 23:05:01,4046680,354968,3766304,205672,56,4063228,3411336,1237080
2023-05-05 23:10:02,4046680,355232,3766568,205672,56,4063228,3411336,1237180
2023-05-05 23:15:02,4046680,368812,3780148,205616,56,4063228,3411336,1239936
2023-05-05 23:20:02,4046680,368168,3779504,205616,56,4063228,3411336,1240232
2023-05-05 23:25:02,4046680,367836,3779172,205616,56,4063228,3411336,1240400
2023-05-05 23:30:02,4046680,392652,3803988,213808,56,4063228,3411336,1248772
2023-05-05 23:35:02,4046680,392100,3803436,213808,56,4063228,3411336,1248940
2023-05-05 23:40:01,4046680,392016,3803352,213808,56,4063228,3411336,1249120
2023-05-05 23:45:01,4046680,391784,3803120,213808,56,4063228,3411336,1249264
2023-05-05 23:50:02,4046680,391908,3803244,213808,56,4063228,3411336,1249392
2023-05-05 23:55:02,4046680,386220,3797556,213808,56,4063228,3411336,1254668
